█████ ███████████████
█████ ███████████████
█     ███████████████
█████           ██ ██
████████ █ ████ ██ ██
████████ █ ████ ██ ██
███████  ██████ █████
█████   █████   █████
███████ █████████████
