█ ████████████████████████████████████████████████
█                                         ████████
█████████ ███████████████████████████████ ████████
█████████ ███████████████████████████████ ████████
███       ███████████████████████████████ ████████
███ █████ ████████████████                ████████
███ █████ ███████████████████████████████ ████████
███ █████ ███████████████████████████████     ████
███ █████ ███████████████████████████████████ ████
███ █████      ██████████████████████████████ ████
███ ██████████ ██████████████████████████████ ████
███ ██████████                           ████ ████
███ ██████████ █████████████████████████ █████████
███ ██████████ █████████████████████████ █████████
███ ██████████ █████████████████████████ █████████
███       ████ █████████████████████████ █████████
█████████ ████         █████████████████ █████████
█████████ ████████████ █████████████████ █████████
█████████ ████████████ █████████████████ █████████
█████████ ████████████ █████████████████ █████████
███       ████████████ █████████████████ █████████
█████████ ████████████ █████████████████ █████████
█████████ ████████████                      ██████
█████████ ██████████████████ ██████████████ ██████
█████████      █████████████ ██████████████ ██████
██████████████ █████████████ ██████████████ ██████
██████████████ █████████████ ██████████████ ██████
█████                 ██████ ██████████████ ██████
█████ ███████████████ ██████ ██████████████ ██████
█████                 ██████        ███████ ██████
██████████ ████████████████████████         ██████
██████████ ████████████████████████████████     ██
███████████████████████████████████████████████ ██
