█████████████████████ ████████████████████████████
████████                             ██          █
██████████ ██████████ ██████████████ ██ ██████████
██████████ ██████████ ██████████████    ██████████
██████                ██████     █████████████████
██████ ███ █████████████████ ███ █████████████████
██     ███ █████████████████ ███ █████████████████
██ ███████        ██         ███ █████████████████
██    ████ ██████ ██ ███████████ ███    ██████████
█████ ████ ██████    ███████     ██  ██ ██████████
█████ ████    ██████████████ ███████ ██ ██████████
█████ ███████ ██████████████         ██ ██████████
█████ ███████ █████████████████████████ ██████████
█████         █████████████████         ██████████
███████████████████████████████ ███████ ██████████
███████████████████████████████████████ ██████████
