██████████████████ ██████████████████████████████████████████████
██████████████████ ██████████████████████████████████████████████
██████████████████ ██████████████████████████████████████████████
██                                                        ███████
██ ███████████ ██████████████████████████████████████████ ███████
██ ███████████ ██████████████████████████████████████████ ███████
██ ███████████                              █████████████ ███████
██ ███████████ ████████████████████████████ █████████████ ███████
██ ███████████ ███████                 ████ █████████████ ███████
██ ███████████ ███████ ███████████████ ████ █████████████     ███
██ ███████████ ███████ ███████████████      █████████████████ ███
██ ███████████ ███████ ███████████████ ██████████████████████ ███
██ ███████████ ███████           █████ ██████████████████████ ███
██ ███████████ ███████████████████████ ██████████████████████ ███
██ ███████████ ███████████████████████ ██████████████████████ ███
██ ██                                                         ███
██ ██ █████████████████████████ █████████████████████████████████
██ ██ ███████████████████                               █████████
██ ██ ███████████████████ █████████████████████████████ █████████
██ ██ ███████████████████ █████████████████████████████ █████████
██ ██ ██████████████                            ███████ █████████
██ ██ █████████████████████████████████████████ ███████ █████████
██ ██ █████████████████████████████████████████ ███████ █████████
██ ██ █████████████████████████████████████████ ███████ █████████
██ ██                                           ███████ █████████
██ ███████████ ██████████████████ █████████████████████ █████████
██ ███████████ ██████████████████ █████████████████████ █████████
██ ███████████               ████ █████████████████████ █████████
██ █████████████████████████ ████ ███████████████████████████████
██ █████████████████████████ ████ ███████████████████████████████
██ █                         ████                   █████████████
██ █ ████████████████████████████████████████████████████████████
██ █ █████████████      ██    ██    ██    ███████████████████████
██ █ █████████████ ████ ██ ██ ██ ██ ██ ██ ███████████████████████
██ █               ████    ██    ██    ██               █████████
██ ████████████████████████████████████████████████████ █████████
██                                                    █ █████████
███████████████████████████████████████████████████████ █████████
███████████████████████████████████████████████████████ █████████
