████ ██████████████████████████████████████████████████
████ ███                    ███████████████████████████
██   ███ ██████████████████ █████████████           ███
██ █                ███████ █████████████ █████████ ███
██ ████████████████ ███████ █████████████ █████████ ███
██ ████████████████ ███████               ███████    ██
██                  ███████ █████████████████████ █████
██ ████████████████ ███████ █████████████████████ █████
██          ███████ ███████ ███████████████   ███ █████
██ ████████ ███████ ███████ ███████████████   ███ █████
██ ████████ ███████ ███████           █████   ███ █████
██ ████████ ███████ █████████████████ ███████████ █████
██ ████████ ███████ █████████████████ ███████████ █████
██           ██████ █████████████████ ███████████ █████
████████████ ██████        ██████████             █████
████████████ █████████████ ███████████████ █████ ██████
████████████ █████████████ ███████████████ █████ ██████
████████████ █████████████ ███████████████ █████ ██████
████████████ █████████████ ███████████████ █████ ██████
████████████ █████████████ ███████████████       ██████
████████████ █████████████ ████████████████████████████
████████████ █████████████ ██████████             █████
████████████           ███                 ██████ █████
██████████████████ ███ ███████████████████ ██████ █████
█                    █ ███████████████████ ██████    ██
██████████████████████                   █ ██████ ██ ██
██████████████████████████████████████████ ██████    ██
██████████████████████████████      ██████ █████████ ██
██████████████████████████████ ████ ██████ █████████ ██
███                 █████      ████        ████      ██
███████████████████ █████ ████████████████ ████████████
███████████████████       ████████████████         ████
██████████████████████████████████████████████████ ████
